111GGGGGGGGGGGGGGGGGGGGGGGG222
111GGGGGGGGGGGGGGGGGGGGGGGG222
111GGGGGGGGGGGGGGGGGGGGGGGG222
GGGGGGGGGGGGGGGGGGGGGGGGGGGGGG
GGGGGGGGGGGGGGGGGGGGGGGGGGGGGG
GGGGGWWWWWWWWGGGWWWWWWWWWGGGGG
GGGGGWWWWWWWWGGGWWWWWWWWWGGGGG
GGGGGWWWWWWWWGGGWWWWWWWWWGGGGG
GGGGGWWWWWWWWGGGWWWWWWWWWGGGGG
GGGGGWWWWWWWWGGGWWWWWWWWWGGGGG
GGGGGWWWWWWWWGGGWWWWWWWWWGGGGG
GGGGGWWWWWWWWGGGWWWWWWWWWGGGGG
GGGGGWWWWWWWWGGGWWWWWWWWWGGGGG
GGGGGGGGGGGGGGGGGGGGGGGGGGGGGG
GGGGGGGGGGGGGGGGGGGGGGGGGGGGGG
GGGGGGGGGGGGGGGGGGGGGGGGGGGGGG
GGGGGWWWWWWWWGGGWWWWWWWWWGGGGG
GGGGGWWWWWWWWGGGWWWWWWWWWGGGGG
GGGGGWWWWWWWWGGGWWWWWWWWWGGGGG
GGGGGWWWWWWWWGGGWWWWWWWWWGGGGG
GGGGGWWWWWWWWGGGWWWWWWWWWGGGGG
GGGGGWWWWWWWWGGGWWWWWWWWWGGGGG
GGGGGWWWWWWWWGGGWWWWWWWWWGGGGG
GGGGGWWWWWWWWGGGWWWWWWWWWGGGGG
GGGGGWWWWWWWWGGGWWWWWWWWWGGGGG
GGGGGGGGGGGGGGGGGGGGGGGGGGGGGG
GGGGGGGGGGGGGGGGGGGGGGGGGGGGGG
333GGGGGGGGGGGGGGGGGGGGGGGG444
333GGGGGGGGGGGGGGGGGGGGGGGG444
333GGGGGGGGGGGGGGGGGGGGGGGG444