111GGG222
111GGG222
111GGG222
GGGGWGGGG
GWGWWWGWG
GGGGWGGGG
333GGG444
333GGG444
333GGG444