// Small 9x9 map, mainly used for testing.
111GGG222
1GGGGGGG2
1GGGGGGG2
GGGGWGGGG
GWGWWWGWG
GGGGWGGGG
3GGGGGGG4
3GGGGGGG4
333GGG444