1111GGGGGGGGGGGGGGGGGGGGGG2222
1GGGGGGGGGGGGGGGGGGGGGGGGGGGG2
1GGGGGGGWWWGGGGGGGGGGGGGGGGGG2
1GGGGGGGWWGGGGGGGGGGGGGGGGGGG2
GGGGGGGGGGGGGGGGGGGGGGGGGGGGGG
GGGGGGGGGGGGGGGGWWWGGGGGGGGGGG
GGGGGGGGGGGGGGGGWWWGGGGGGGGGGG
GGGGGGWWWWWGGGGGWWWGGGGGGGGGGG
GGGGGGWWWWWGGGGGGGGGGGGGGGGGGG
GGGGGGGGGGGGGGGGGGGGGGGGGGGGGG
GGGGGGGGGGGGGGGGGGGGGGGGGGGGGG
GGGGGGGGGGGGGGGGGGGGGGGGGGGGGG
GGGGGGGWWWWWGGGGGGGGGGGGGGGGGG
GGGGGGGWWWWWGGGGGGGGGWWGGGGGGG
GGGGGGGWWWWWGGGGGGGGGWWWWGGGGG
GGGGGGGWWWWWGGGGGGGGGGWWGGGGGG
GGGGGGGWWWWWGGGGGGGGGGGGGGGGGG
GGGGGGGGGGGGGGGGGGGGGGGGGGGGGG
GGGGWWWGGGGGGGGGGGGGGGGGGGGGGG
GGGGGWWWWGGGGGGGGGGGGGGGGGGGGG
GGGGGWWWGGGGGGGGGGGGGGGGGGGGGG
GGGGGGGGGGGGGGGGGGGGGGGGGGGGGG
GGGGGGGGGGGGGGGWWWWGGGGGGGGGGG
GGGGGGGGGGGGGGGWWWWWGGGGGGGGGG
GGGGGGGGGGGGGWWWWGGGGGGGGGGGGG
GGGGGGGGGGGGGGGGGGGGGGGGGGGGGG
3GGGGGGGGGGGGGGGGGGGGGGGGGGGG4
3GGGGGGGGGGGGGGGGGGGGGGGGGGGG4
3GGGGGGGGGGGGGGGGGGGGGGGGGGGG4
3333GGGGGGGGGGGGGGGGGGGGGG4444